C 








1111111111111111111    111111111      
       10000000000000001
10S0000000    111111111
1111111111111111111111111111